#key	path
|key used for urlOf-
~Creativity
imran/writing	imran/writing	so its easy for the site to work
vishnuvasu	vishnuvasu
srividya	srividya
khushwant	khushwant
~Networks
aurrrah	aurrrah
vishwas	vishwas
zvmworld	zvmworld
commonplanet	commonplanet
~People
chandrasekar	chandrasekar
rahul	rahul
|~by Vidya Shankar
|awakentolife	awakentolife
|vidyantara	vidyantara
~Work Folk
interlink	iscindia
the-watchmaker	the-watchmaker
